11111
10C01
100X1
1P1E1
11111
