11111
10C01
10101
1P1E11
11111
