11111
10C01
10101
1P1E1
11111
