11111
10C01
10101
1P1E1
10001
111111
